##########
S...#.##.#
###.#....#
#.#.#.#.##
#.#...#..G
#.#.####.#
#.#....#.#
#.#.##...#
#...#..#.#
##########